7 10 0 9 6 0
*3 /2 NA -8 NA NA -2 NA *3 *2
*8 NA +2 -4 +5 NA *1 +5 /2 NA
/5 NA -5 -5 *2 +5 -2 *4 NA NA
+5 -2 -1 NA +3 -6 NA NA *3 -2
-1 *4 /2 NA -5 -4 +5 *2 NA *3
NA +5 *3 NA -2 *4 NA +3 *2 -2
*1 -6 NA NA -3 /2 *2 +8 -2 +2