7 10 6 0 0 9
NA +3 NA *3 NA /2 -5 -4 +4 *6
-5 /2 /4 -3 NA +4 *1 +2 *4 NA
*9 -9 +9 +6 NA /3 +8 +2 NA +8
+9 NA NA NA NA +9 *8 /2 +6 NA
*3 +4 -3 /6 -5 NA NA NA *9 *4
/2 /4 *1 +3 *6 NA -3 *3 +4 /3
+3 -1 /2 -7 -2 /3 *5 *3 +8 /6

