7 10 0 0 6 9
+1 +2 -5 /8 *5 *2 NA -8 NA *8
-1 *2 NA +4 +6 NA NA -5 -3 -8
NA *3 -1 /4 -3 NA NA /5 /2 *6
*4 /2 *8 *5 NA /1 +6 NA +9 NA
-8 +4 +1 NA -5 -3 +2 NA NA +6
*8 +7 -3 -1 *2 -6 *5 NA NA -4
-6 /1 /2 /6 +3 /8 *4 +7 +2 *5