7 10 6 9 0 0
+1 *2 +8 -5 NA NA -2 NA *3 *2
*8 NA +2 -8 +5 NA *1 +5 /4 NA
/5 *9 -5 NA *2 +5 -2 *4 NA NA
+6 -2 -1 NA +3 -6 NA NA NA NA
-2 *4 /2 NA -4 -4 +5 *2 NA *3
NA +5 *3 -8 -2 *4 NA NA *2 -3
*4 -6 NA +4 -3 /2 *2 +8 -2 +2